############################################################
#       #                   #                              #
#       #                   B                              #
#       #                   B                         ######
#     ###          ####     ######                #        #
#                                        #####             #
##              ##                           #             #
#      #####             #####               ##            #
#                                    #####                 #
#####                                                      #
#                          ######         ####             #
#            ####          #                        ####   #
#  ###                     #                ##             #
#                          #                               #
#           ###            #                      ###      #
#                    #########################             #
#                          #                          ######
#             #            #                               #
#           ####           #########                       #
#             #                                    ####    #
########      #     ###                                    #
#             #                            ###           ###
#           ###           ###                        ##    #
#                                   #####                  #
#######                                    ##      #       #
#             ##    #         ###                  #   ##  #
#                    #                            #        #
###########           #####                      #        ##
#  J            #                               #          #
############################################################