############################################################
#                            #                   #####     #
#                            #                             #
# J                         ##                             #
######                       #                         #####
#                            #     ##########              #
#                            ##             B              #
                             #              B              #
#                                  ##########              #
#                                  #                       #
#                                  #                       #
#                                  #                       #
#                                  #                       #
#                                  ####################    #
#                                  #                       #
#         #######           ########                       #
#                           #                              #
#                           #                              #
#                    ##############                        #
##########                                                 #
#                                                          #
#                                       ########           #
#                                                          #
#                      #######                             #
#                                                          #
#                                                          #
#      #########                                           #
#        #                   #####                         #
#        #                                                 #
############################################################